Drupal < 8.5.11 / < 8.6.10 - RESTful Web Services unserialize() Remote Command Execution (Metasploit)	Remote	PHP	Metasploit
Drupal < 8.6.9 - REST Module Remote Code Execution	WebApps	PHP	leonjza
Drupal < 8.6.10 / < 8.5.11 - REST Module Remote Code Execution	WebApps	PHP	Charles Fol
Drupal < 7.58 - 'Drupalgeddon3' (Authenticated) Remote Code (Metasploit)	WebApps	PHP	SixP4ck3r
Drupal < 7.58 - 'Drupalgeddon3' (Authenticated) Remote Code Execution (PoC)	WebApps	PHP	Blaklis
Drupal avatar_uploader v7.x-1.0-beta8 - Arbitrary File Disclosure	WebApps	PHP	Larry W. Cashdollar
Drupal < 8.3.9 / < 8.4.6 / < 8.5.1 - 'Drupalgeddon2' Remote Code Execution (Metasploit)	Remote	PHP	José Ignacio Rojo
Drupal < 7.58 / < 8.3.9 / < 8.4.6 / < 8.5.1 - 'Drupalgeddon2' Remote Code Execution	WebApps	PHP	Hans Topo & g0tmi1k
Drupal < 8.3.9 / < 8.4.6 / < 8.5.1 - 'Drupalgeddon2' Remote Code Execution (PoC)	WebApps	PHP	Vitalii Rudnykh
Drupal 7.0 < 7.31 - 'Drupalgeddon' SQL Injection (Admin Session)	WebApps	PHP	Stefan Horst
Drupal 7.x Module Services - Remote Code Execution	WebApps	PHP	Charles Fol
Drupal Module CODER 2.5 - Remote Command Execution (Metasploit)	WebApps	PHP	Mehmet Ince
Drupal Module Coder < 7.x-1.3/7.x-2.6 - Remote Code Execution	Remote	PHP	Raz0r
Drupal Module RESTWS 7.x - PHP Remote Code Execution (Metasploit)	Remote	PHP	Mehmet Ince
Drupal Module Drag & Drop Gallery 6.x-1.5 - 'upload.php' Arbitrary File Upload	WebApps	PHP	Sammy FORGIT
Drupal < 7.34 - Denial of Service	DoS	PHP	Javer Nieto & Andres Rojas
Drupal Module Cumulus 5.x-1.1/6.x-1.4 - 'tagcloud' Cross-Site Scripting	WebApps	PHP	MustLive
Drupal Module CAPTCHA - Security Bypass	WebApps	PHP	anonymous
Drupal 7.0 < 7.31 - 'Drupalgeddon' SQL Injection (Remote Code Execution)	WebApps	PHP	Stefan Horst
Drupal Module Embedded Media Field/Media 6.x : Video Flotsam/Media: Audio Flotsam - Multiple Vulnerabilities	WebApps	PHP	Justin Klein Keane
Drupal 7.0 < 7.31 - 'Drupalgeddon' SQL Injection (PoC) (Reset Password) (2)	WebApps	PHP	Dustin Dörr
Drupal 7.0 < 7.31 - 'Drupalgeddon' SQL Injection (Add Admin User)	WebApps	PHP	Claudio Viviani
Drupal 7.0 < 7.31 - 'Drupalgeddon' SQL Injection (PoC) (Reset Password) (1)	WebApps	PHP	stopstene
Drupal < 5.22/6.16 - Multiple Vulnerabilities	WebApps	PHP	David Rothstein
Drupal Module Sections 5.x-1.2/6.x-1.2 - HTML Injection	WebApps	PHP	Justin C. Klein Keane
Drupal Module Ajax Checklist 5.x-1.0 - Multiple SQL Injections	WebApps	PHP	Justin C. Klein Keane
Drupal 4.x - URL-Encoded Input HTML Injection	WebApps	PHP	liz0
Drupal Module CKEditor < 4.1WYSIWYG (Drupal 6.x/7.x) - Persistent Cross-Site Scripting	WebApps	PHP	r0ng
Drupal 4.1/4.2 - Cross-Site Scripting	WebApps	PHP	Ferruh Mavituna
Drupal 4.0 - News Message HTML Injection	WebApps	PHP	das@hush.com
Drupal 7.12 - Multiple Vulnerabilities	WebApps	PHP	Ivano Binetti
Drupal Module CKEditor 3.0 < 3.6.2 - Persistent EventHandler Cross-Site Scripting	WebApps	PHP	MaXe
Drupal 6.15 - Multiple Persistent Cross-Site Scripting Vulnerabilities	WebApps	PHP	emgent
Drupal 5.21/6.16 - Denial of Service	DoS	PHP	emgent
Drupal Module Sections - Cross-Site Scripting	WebApps	PHP	Justin C. Klein Keane
Drupal 5.2 - PHP Zend Hash ation Vector	WebApps	PHP	ShAnKa				Drupal < 4.7.6 - Post Comments Remote Command Execution	WebApps	PHP	str0ke
Drupal < 5.1 - Post Comments Remote Command Execution	WebApps	PHP	str0ke2006-05-24				Drupal 4.7 - 'Attachment mod_mime' Remote Command Execution	WebApps	PHP	rgod
Drupal 4.5.3 < 4.6.1 - Comments PHP Injection